# Maze 1 File,
Rows,16,
Columns,16,
*,*,*,*,*,*,*,*,*,*,*,*,*,*,*,*
*,s,_,_,_,_,_,_,_,_,_,_,_,_,_,*
*,*,_,_,_,*,*,*,*,*,*,*,*,*,_,*
*,*,_,_,_,_,_,_,_,_,_,_,_,_,_,*
*,*,_,*,*,*,_,*,*,*,*,*,*,*,_,*
*,*,_,*,*,*,_,*,*,*,*,*,*,*,_,*
*,*,_,*,*,*,_,*,*,*,*,*,*,*,_,*
*,*,_,*,*,*,_,*,i,*,_,_,_,_,_,*
*,*,_,*,*,*,_,*,_,*,_,*,*,*,*,*
*,*,_,*,*,*,_,_,_,*,_,_,*,*,*,*
*,*,_,*,*,*,*,*,*,*,*,_,_,_,_,*
*,*,_,*,*,*,*,*,*,*,*,*,_,*,_,*
*,*,_,*,*,*,*,*,*,*,*,*,_,*,_,*
*,*,_,*,_,_,_,_,_,_,_,_,_,_,_,*
*,*,_,_,_,*,*,*,*,*,*,*,_,*,_,*
*,*,*,*,*,*,*,*,*,*,*,*,*,*,*,*


# -all outer boundaries of maze need to be *
# -Spaces not allowed
# -first line comments
# -second line rows
# -third line columns
# - * = wall
# - _ = path empty
# - s = start point
# - i = item